14 14 14 14 14 14 14 14 14 14 14 14 14 14 14 14 14 14
14  0  0  0  0 14 12 12 12 12 12 12 12 12  2 17 12 14
14  0  0  0  0 14  2 11  2  2  2 12 12 12  2  2 12 14
14  0  0  0  0 14  2 14 14 14  2 12 12 12  2  2 12 14
14  0  0  0 14  2  2 14  4  2  2 12 12 12  2  2 12 14
14  0  0  0 14  2 14 15 15 15 14 12 12 12  2  2 12 14
14  0  0  0 14  2 14  2  2  2 15 14 14 14  2  2 12 14
14  0  0  0 14  2 12 14  1  2 15  0 11 11  0  2 12 14
14  0  0  0 14  2 12 12 14  2 10 17 14 14  2  2 12 14
14  0  0  0 14  2 12 12 12 14 14  0 10 17 14 12 12 14
14  0  0  0 14  2  2  2  2  2  2  2 14 14  0 12  0 14
14  0  0  0 14 14 14 14 14 14 14 14  0  0  0  0  0 14
14  0  0  0  0  0  0  0  0  0  0  0  0  0  0  0  0 14
14  0  0  0  0  0  0  0  0  0  0  0  0  0  0  0  0 14
14  0  0  0  0  0  0  0  0  0  0  0  0  0  0  0  0 14
14  0  0  0  0  0  0  0  0  0  0  0  0  0  0  0  0 14
14  0  0  0  0  0  0  0  0  0  0  0  0  0  0  0  0 14
14 14 14 14 14 14 14 14 14 14 14 14 14 14 14 14 14 14