14 14 14 14 14 14 14 14 14
14 17  2 11 11 11 11  2 14
14  2 11 11 11 11  2 15 14
14  2 15 15  2  2 15 12 14
14  2 12  2  2  2  2 15 14
14 17 10  0  2  2  2 12 14
14 14 10  2  2  4  2 15 14
14  1 10 10 10 10 10  2 14
14 14 14 14 14 14 14 14 14