14 14 14 14 14 14 14 14 14 14 14 14 14 14 14 14 14 14
14  0  3 10 10 10 10 10  0  3 14  0  0  0  0  0  1 14
14  3  0 15 15 15 15  3  0  3 14  0  0 15 15 15  0 14
14  3 15  3  3  3  3  3  0 14  0  0 15  0  0  0 15 14
14  3 15  3  0  0  0  0  0 14 12 12  0 15 15  0 15 14
14  3 15  3  0  0  0  0  0 14 12 12 12  0  0 15 15 14
14  3 15  3  0  0  0  0  0 14  2 17 10 10 10  0 15 14
14  3 15  3  0  0  0  0 14 13 12 12 12  0  0  0 15 14
14  3 12  3  0  0 15 14  0 12 12 12  0  0  0  0  0 14
14  3 13  0  0  0 15 14  0  0  0 17  0  0  0  0  0 14
14  3 12  0 14  0 15 14  0  0  0  0  0  0  0  0  0 14
14  3 13  0 14  0 14 14  0  0  0  0  0  0  0  0  0 14
14  3 12  0 14  0  0  0 14 14 14 14 14 14 14 14  0 14
14  3  3 11  0  0 13  0 14 15  2  2 11 11 11 11 15 14
14  3  3  0 14  0 12  0 14 15  2  2 10 10 10 10  2 14
14  3  3  0 14  0 13  0 14 15  2  2 15 15 15 15 15 14
14  3  3  0 14  0 12  0 14  4  2  2 15  2 15 15 15 14
14 14 14 14 14 14 14 14 14 14 14 14 14 14 14 14 14 14