14 14 14 14 14 14 14 14 14
14  0  0 11  0  1  0  0 14
14  0  0  0  0  0  0  0 14
14  0 15 12  0  2  0  0 14
14  0 12  0  0  2  0  0 14
14  0  0  0  0  2  2  0 14
14  0 10  0  0  4  2  0 14
14  0  0  0  0  0  0  0 14
14 14 14 14 14 14 14 14 14