14 14 14 14 14 14 14 14 14 14 14 14 14 14 14 14 14 14
14  4  2 10 10 10 10 10  0  2 14  0  0  0  0  0  0 14
14  2  1 15 15 15 15  2  0  2 14  0  0 15 15 15  0 14
14  2 15  2  2  2  2  2  0 14  0  0 15  0  0  0 15 14
14  2 15  2  0  0  0  0  0 14  0  0  0 15 15  0 15 14
14  2 15  2  0  0  0  0  0 14 12 12  0  0  0 15 15 14
14  2 15  2  0  0  0  0  0 14  0 17 10 10 10  0 15 14
14  2 15  2  0  0  0  0 14 13 12 12  0  0  0  0 15 14
14  2 12  2  0  0 15 14  0  0  0  0  0  0  0  0  0 14
14  2 13  0  0  0 15 14  0  0  0 17  0  0  0  0  0 14
14  2 12  0 14  0 15 14  0  0  0  0  0  0  0  0  0 14
14  2 13  0 14  0 14 14  0  0  0  0  0  0  0  0  0 14
14  2 12  0 14  0  0  0 14  0  0  0  0  0  0  0  0 14
14  2  2 11  0  0 13  0 14  0  0  0 11 11 11 11 15 14
14  2  2  0 14  0 12  0 14  0  0  0 10 10 10 10 15 14
14  2  2  0 14  0 13  0 14  0  0  0 15 15 15 15 15 14
14  2  2  0 14  0 12  0 14  0  0  0 15  0 15 15 15 14
14 14 14 14 14 14 14 14 14 14 14 14 14 14 14 14 14 14